Vito control=Sterowanie Vito
Vito info=Vito info
Outside=Na zewnątrz
Inside=W pokoju
Warm water=Woda użytkowa
Operating mode=Tryb pracy
OFF=OFF
WW=CW
WW+H=CW+CO
Boiler temperature=Temperatura kotła
Fumes temperature=Temperatura spalin
Burner power=Moc palnika
WW circ.=Cyrkulacja C.W.
WW heating=Grzanie C.W.
Heating circ.=Cyrkulacja C.O.
Normal (day)=Normalna (dzień)
Reduced (night)=Zredukowana (noc)
Party Mode=Tryb Party
Warm water=Woda użytkowa
Boiler time=Czas pieca
Burner starts=Starty palnika
Working time=Godziny pracy
Schedulers=Harmonogramy
Settings=Ustawienia
Normal/reduced mode=Tryb normalny/noc
Mon=Pon
Tue=Wto
Wed=Śro
Thu=Czw
Fri=Pią
Sat=Sob
Sun=Nie
Copy Monday=Kopiuj poniedziałek
Save=Zapisz
Read=Odczytaj
Basic=Podstawowe
Coding 1=Kodowanie 1
Coding 2=Kodowanie 2
Curve slope=Nachylenie k.
Curve level=Poziom k.